######### #########
#.......###.......#
#.......|./.......#
#.......###.......#
######### ####.####
             #.#
             #.#
             #.#
             #.#
             #.#
             #.#
             #.#
             #.#
             #.#
##############/#############################
#..........................................#
#..........................................#
#..........................................#
#....p.....................................#
#..........................................#
#..........................................#
############################################