######### #######################
#.......###............#........#
#.......|./............|........#
#.......###............#........#
######### ####.###############.##
             #.#             #.#
             #.#             #.#
             #.#             #.#
             #.#             #.#
             #.#             #.#
             #.#             #.#
             #.#             #.#
             #.#             #.#
             #.#             #.#
##############/###############|#############
#..........................................#
#..........................................#
#..........................................#
#....p.....................................#
#..........................................#
#..........................................#
############################################