######### #########
#.......###.......#
#..p....|.|.......#
#.......###.......#
######### ####.####
             #.#
             #.#
             #.#
             #.#
             #.#
             #.#
             #.#
             #.#
             #.#
##############|#############################
#..........................................#
#..........................................#
#..........................................#
#..........................................#
#..........................................#
#..........................................#
############################################